kti government will said karachi	business
percent s points kong markets	business
kicked wall points seng kong hong	business
oil percent yen monday eurozone	business
oil us barrel key	business
saudi arabia market will prices barrel	business
s points kse karachi stock investors	business
prices singapore ang wti said s	business
sugar kg market crushing rs dropped	business
crude us s oil said outlook	business
tokyo ruble yen percent tuesday	business
hang added hong kong points stocks	business
million barrels oil friday will barrel	business
shipment thursday situation pakistan shortage	business
prices levels barrel said us	business
stations petrol petroleum also oil	business
rs will notification reduction s consumers	business
percent programme points rose yen wednesday	business
per available wheat import ecc tons	business
king s oil minister prices saudi	business
back return electric rent customer per	business
enterprise various company future brunei investment	business
oil pay s pakistan	business
petrol since oil country rs per	business
percent yen monday syriza s will	business
said output oil us percent	business
islamic banks year percent compliant	business
us data since re march barrel	business
rupees billion rs minister dar federal	business
risk bonds s department deals mortgage	business
oil since percent global tuesday	business
s minister shedding load added industries	business
crude prices us decision s greek	business
pakistan imf mission billion chief	business
will pakistan engines railways shipment	business
jobs barrel thursday prices oil crude	business
mw supply production said	business
yen thursday friday tokyo banks	business
price rs january percent bought country	business
us week jobs said oil percent	business
hsbc bank accounts tax french lagarde	business
march cents market year oil prices	business
truck said pakistani trade kashmir	business
tapi meetings pakistan project petroleum minister	business
generate australia world cup hotels bookings	business
mobile people nokia dual hours phone	business
minister funds rs billion numbers national	business
revenue government percent regulatory imported duty	business
s wednesday us stockpiles oil market	business
year us oil investment crude production	business
gradually consumers otherwise affected oil rs	business
electric relief power per authority notification	business
deal energy s lng said	business
percent eurozone yen tuesday new public	business
pakistan minister dar pakistani armed jack	business
oil delivery crude prices us report	business
car team maker people apple	business
brent said crude wti trade us	business
lng khaqan import power will said	business
us oil strike refineries crude	business
rs sold wholesale market decrease	business
us crude brent market lower	business
bailout obtaining yen monday tokyo euro	business
rs ministry said sources litre diesel	business
oil crude us barrel percent	business
total bank electricity pakistan tajikistan country	business
crude monday week prices us	business
hong kong monday s points index	business
s year billion last	business
electricity added said power will minister	business
s ukraine oil million us crude	business
mw powered will karachi speaking exclusively	business
security ahmed imf pakistan said	business
tax government fbr pakistan percent	business
s euro since asia year fed	business
cng outlets gas	business
crude us futures brent prices	business
director imf increase s monetary	business
oil crude us energy iea	business
ppi iraq gas islamabad also approved	business
week last oil said crude us	business
bank sbp rate policy percent expecting	business
weekly lower us crude prices	business
said salaries railways minister also plan	business
market stock points index remained bearish	business
said will june since us stockpiles	business
s rate dollar percent yen yellen	business
interest rates eight one percent rate	business
high s crude day oil lower	business
s pakistan economy foreign	business
us data march s hsbc index	business
lng will gas power	business
points fell yen s percent pesos	business
crude yemen prices oil	business
points trading lost per stocks index	business
dollar s demand said production	business
rs will litre per petrol	business
s pakistan foreign million also	business
rs litre high prices ogra	business
ministry reserves gas pakistan petroleum	business
country imf foreign sbp sources s	business
us report bomb metres nuclear mccarthy	business
pakistan mobile manufacturing formulated will free	business
iran nuclear barrel since crude us	business
oil market crude prices deal analysts	business
oil s nuclear sanctions crude day	business
last us points fell percent yen	business
decrease fuel power authority price unit	business
oil s said week crude	business
said shares government saturday islamabad	business
plants lng minister finance	business
first dollars year said remittances scheme	business
yen will s months percent hong	business
bank central credit banks government investment	business
day barrels us oil said smith	business
visit s china pakistan financial ready	business
percent s us needs yen	business
s production said global largest new	business
chinese minister will said projects investment	business
yen s trade us percent	business
s oil yemen said prices	business
investment pakistan punjab minister china lahore	business
last said projects will power asif	business
percent thursday euro yen added	business
transportation coal freight times	business
rs price sources news complete	business
agriculture introducing said government agricultural dar	business
percent stocks yen japanese tokyo us	business
respectively rs litre petroleum prices	business
points percent us fell s	business
believe pakistan nestl relationship maxus digital	business
per litre rs price prices oil	business
city first s expo italy will	business
prices said afp however april market	business
oil said states gulf countries	business
billion said s pakistan year	business
moratorium said bank kasb spokesman	business
points index trade tokyo percent us	business
thursday jobs tokyo us yen friday	business
thursday positive friday percent yen trade	business
billion eff imf finance th review	business
said year pakistan imf led billion	business
port gwadar handling cargo containerised shipment	business
fertilizers added karachi share market decline	business
s country pakistan billion projects plant	business
oil prices dollar crude us	business
us crude s week oil	business
sector telecom s will said government	business
obama alaska shell said oil us	business
government budget tax reform finance	business
brazil investment li will china	business
oil crude key cents barrel	business
project gas said cess	business
us may said prices oil crude	business
brazil china billion s rousseff trade	business
rs may price increase geo june	business
electric authority consumers will cut tariff	business
bank state business rate interest	business
adding year points rose percent closed	business
rate reduced people prime cabinet geo	business
crude tuesday us report prices	business
us prices s ang crude	business
petroleum ogra rs expected increase	business
stations reopen cng capital gas	business
billion development year islamabad growth meeting	business
will budget billion water	business
regulatory power decrease adjustment electric consumers	business
hours shedding directed ramazan islamabad	business
cent per growth grew pakistan	business
growth economic percent target survey development	business
percent said will rupees	business
budget wheat said imposed poor meant	business
prices petroleum iran s million day	business
report said billion gulf remittances states	business
s moody rating credit	business
provincial budget year fiscal rs bn	business
us stronger lower yen tokyo	business
receipts rs shame assembly billion	business
police compared said murad minister finance	business
percent increase finance minister government bn	business
country economic power will said	business
broadband mobile can per service time	business
bank sbp rs fixed zakat nisab	business
new said rs billion	business
economy carrier fares month passengers	business
rose close points fell percent s	business
barrage will infrastructure irrigation guddu rehabilitation	business
cng closure gas will hours	business
government greek s nuclear brussels monday	business
minister pakistan reserves exceeded billion commercial	business
next gilgit expenditures development gb sunday	business
airline suspension safety caa	business
signatures bill president national june	business
percent s market points markets yen	business
caa court safety unsafe air indus	business
billion rice imf request tuesday greece	business
oil s crude situation weekly build	business
s percent pakistan report	business
percent s china market trading many	business
percent said economy unchanged forecast	business
percent government bank withholding tax traders	business
transaction waqas sindh nab rs sq	business
insurance pakistan scbpl illness	business
minutes federal said june wednesday new	business
percent market s barrels oil prices	business
will eid reduction announced discount	business
likely prices nepra hearing power per	business
yen greece euro three will s	business
abbasi begin agreement pakistan pipeline	business
s barrels dollar said evans oil	business
s said oil iran year	business
year period fy percent inflows debt	business
regulatory power tariff cut approved	business
percent end s p dow second	business
market local since weighed metal prices	business
us markets yen tokyo percent index	business
s said oil new market benchmark	business
percent said gold s ounce metal	business
euro greece parliament government s said	business
us said record barrels million	business
yen dollar us s percent expected	business
monetary announced sbp	business
bank said us crude oil dollar	business
pakistan received year billion afghanistan	business
market us percent state yen said	business
microsoft s windows will devices mobile	business
global get yen september percent s	business
prices cut decrease rs price	business
rs class charges aviation international will	business
volkswagen market s pakistan investment	business
s pipeline nuclear economic iran	business
malmstroem said will issues eu trade	business
gold ounce s since percent	business
digital million said	business
supply stations gas cng continue	business
tax billion million fbr	business
friday will oil crude us september	business
reforms revenue tax fbr year	business
percent s day currency yuan	business
us said oil cents demand dealers	business
said tax income rs file	business
barrels per s currency said	business
percent wednesday fell dollar us	business
spokesman closed will stations days	business
asia said will us oil	business
s buzzfeed investment media	business
demand said output increased oil also	business
said oil barrel see us	business
vehicles said customs tax	business
said market dollar exchange foreign	business
team manager mohammad pcb world	sports
pcb squad mohammad ahmed team coach	sports
said cricket afridi media board tweets	sports
unit international anti corruption	sports
security monday member india team	sports
world one angeles los	sports
security pakistan pakistani cricket government match	sports
strong twitter s capriati jennifer	sports
scotland shahzad slower noor overs start	sports
team security will cup world	sports
t nagpur scotland world four balls	sports
spinner picked said stanikzai nagpur	sports
zimbabwe hit balls two hong kong	sports
will pakistan security team india lahore	sports
wickets zimbabwe sibanda waller two slow	sports
chose order kong hong masakadza raza	sports
tournament s bangladesh india side	sports
malinga remained available s captain	sports
nashville vanderbilt espn work video hotel	sports
test positive champion tennis sharapova	sports
david wk south africa changes s	sports
south africa took west indies	sports
three top ali openers ireland two	sports
scored top spinner arm ireland first	sports
left wednesday captain oman andy spinner	sports
icc br security teams match threats	sports
netherlands win s last four one	sports
first match bangladesh bowler three tamim	sports
kept mustafizur bangladesh dharamsala van captain	sports
security match delhi chief richardson	sports
pakistan chief decision nisar india	sports
failed sharapova announcement s drug	sports
bangladesh match first overs rain pm	sports
al runs ireland first match	sports
two rain oman captain match	sports
safety said s travel pakistan cricket	sports
pakistan commissioner cricket team sources said	sports
cricket india also ministry pakistan	sports
indian media quoted saying pakistan assured	sports
watt like win since scotland kong	sports
security team buses india pakistan	sports
kong hong spinner left runs rath	sports
spinner left captain khan made hong	sports
afghanistan total zimbabwe wickets balls four	sports
balls six wickets runs first zimbabwe	sports
win xi will match zimbabwe zadran	sports
india security s pakistan younus waqar	sports
will team world tournament pakistan	sports
doping media champion strong sharapova hit	sports
oman rain dharamsala s	sports
runs tamim two th playing	sports
game netherlands captain ali match toss	sports
ireland van netherlands win s ball	sports
interruption however van captain ireland first	sports
said play kolkata	sports
balls two bowler wickets england mumbai	sports
pakistan sri wicket runs won toss	sports
wickets lanka runs sri two ahmed	sports
sri pakistan mohammad captain lanka	sports
afridi advocate sunday legal served	sports
williams overwhelmed set seed	sports
mendis loss sri lanka wicket manodara	sports
spinner t india zealand get record	sports
new zealand s first	sports
women bangladesh two wickets mithali death	sports
world martin captain zealand won india	sports
cab president cricket eden clash official	sports
match lot s will kolkata twenty	sports
strong form zealand india new	sports
mohammed indies first pakistan west	sports
england s sixes mumbai	sports
captain chris willey jason england west	sports
left arm bangladesh earlier pakistan runs	sports
shehzad hafeez four ball bangladesh pakistan	sports
match world mohammad ahmed left arm	sports
pakistan pair bangladesh games runs	sports
first lanka overs tillakaratne kolkata super	sports
strong stanikzai first thursday	sports
england said side steyn ground s	sports
will india cricket s match massive	sports
africa south australia balls s ismail	sports
wickets two balls three england root	sports
balls spinner sixes fours de south	sports
afridi pakistan said s india match	sports
score overs new zealand run devine	sports
br match captain de england	sports
new zealand runs shane mitchell justified	sports
injury due tournament defence	sports
new zealand australia dharamsala match two	sports
pakistan india kolkata coach match said	sports
india rivals zealand new captain	sports
india match pti t left say	sports
billion million strongfifa first	sports
singh overs balls kohli pakistan wicket	sports
pakistan overs made mohammad	sports
wasim khan mohammad pakistan india unchanged	sports
cricket match thanked gardens imran	sports
pakistan said bachchan indian s amitabh	sports
will take kolkata rain pm going	sports
overs pakistan veda pandey match	sports
women india runs pakistan scored just	sports
khan pakistan coach players captain world	sports
women delhi said india match	sports
ground cricket match rain clash kolkata	sports
american opening williams radwanska set win	sports
year pacer cricket kohli ahead	sports
west indies spinner wickets russell three	sports
governor office istanbul start stadium	sports
wickets dwayne sri lanka	sports
west indies lanka sri fast one	sports
runs afghanistan africa south will just	sports
matthews made bangladesh women overs	sports
de kock two six africa south	sports
total meagre match turn india s	sports
one strongthe opposition captain strong	sports
dir khan team women strong islamabad	sports
spinner watson australia zealand bangladesh three	sports
bangladesh first opponents starting struck balls	sports
rahman captain bangladesh due sajib side	sports
new zealand balls six three spinner	sports
three australia four runs jess jonassen	sports
cricket series said team affair	sports
sunny international match s world	sports
decision will captain shahryar team match	sports
new zealand balls afridi pakistan caught	sports
zealand new two afridi guptill mohammad	sports
zealand new pakistan khalid mohammad captain	sports
women match india three wickets two	sports
women runs three captain india	sports
vital without will s	sports
bangladesh run	sports
bangladesh two first raina lost	sports
captain al line made australia arm	sports
england seven balls unbeaten two made	sports
two made ali balls england wickets	sports
decided pcb team asia	sports
first won england zadran afghanistan	sports
bowling illegal arm	sports
player declared women s runs target	sports
international last s year	sports
strong malik said team bowler amir	sports
wickets indies two batsmen africa south	sports
twenty cricket australia afridi pakistan mohali	sports
david innings scored world south indies	sports
chris david south first line led	sports
imad pakistan australia four runs three	sports
wicket runs smith pakistan bowled australia	sports
said skipper mohali match mohammad afridi	sports
greatest cancer strongthe outpouring coach inventive	sports
balls s africa south three space	sports
runs four england fours sixes	sports
england ball two spinner buttler runs	sports
game south england one captain wk	sports
new zealand three batsmen bangladesh best	sports
seven group australia match help	sports
ireland women get double three	sports
runs williamson best bowling zealand new	sports
came rested zealand world pakistan	sports
australia six india s	sports
runs women england innings wickets	sports
finch main zealand new india wickets	sports
beaumont edwards wickets nida women england	sports
world twenty said won match australia	sports
india run west indies total s	sports
two wickets afghanistan overs west indies	sports
made dottin bowler wicket indies	sports
indies west zadran made captain set	sports
world semi afghanistan group captain mohammad	sports
south africa six remained sri lanka	sports
south africa chandimal dinesh spinner sri	sports
atapattu t women balls keeper	sports
south africa back replaced sri lanka	sports
kohli australia s world	sports
watson international t rankings world tournament	sports
coach head strong pakistan	sports
new final team tournament s england	sports
made three second england new	sports
known pistorius news following	sports
new zealand fours six england captain	sports
mitchell england semi final new zealand	sports
report pcb waqar said also	sports
s ball run england women australia	sports
pandey batsman will place s india	sports
s opening world champions	sports
argentina di th points	sports
cricket captain said play nation	sports
people killed france paris	sports
fours sixes made kohli final world	sports
total highest india kohli second	sports
west indies captain wk place pandey	sports
s women devine sophie wickets three	sports
finch warne india ranked	sports
team alam pakistan losing world	sports
two fourth court ending second miami	sports
said speaking media dismal asia	sports
pcb shahryar tournament pakistan s said	sports
s scored batsman mumbai nine since	sports
s indies england title side	sports
sammy gayle west indies s team	sports
four balls indies west bravo two	sports
match april first wickets runs whereas	sports
team kolkata three wickets england west	sports
west indies captain chris england	sports
women first west indies balls made	sports
team afridi t pakistan cricket	sports
twenty west s final men	sports
pcb s t world committee selection	sports
west indies t cricket cameron players	sports
pakistan series t s pcb	sports
s journalists final west victory four	sports
s players england zealand former icc	sports
doping agency zealand new banned positive	sports
runs wickets b sri lanka	sports
will competition zealand new malaysia	sports
s captain reach strongthe pakistan afridi	sports
said april million rs tennis table	sports
st indies icc four stadium honour	sports
test will another day match night	sports
canada zealand match th pakistan lead	sports
muhammad will bowlers cricket camp	sports
one chile s cup top th	sports
cricket young india s performance tattad	sports
national wicket wickets took overs skipper	sports
pakistan teams team fed will pool	sports
said players team azhar cricketers	sports
cricket s minister team said also	sports
daredevils balls first got s run	sports
score u khan tennis club modern	sports
balls pune br mumbai	sports
olympic s world lee said chen	sports
said twitter england airport messages	sports
last bravo finch lions boundaries ball	sports
blind cricket pakistan said will	sports
will cricket cup pentangular faisalabad iqbal	sports
stephens set carolina south american	sports
coach pcb week new board khan	sports
india delhi year sania hingis incredible	sports
ipoh canada pakistan india singh	sports
heart condition cricket england viral last	sports
six every s established mumbai buttler	sports
s england williamson bairstow cricketer batsman	sports
right arm u player pakistan pcb	sports
goal record s season	sports
royal challengers second sunrisers ball	sports
mohammad championship snooker cueists strong	sports
said body positive sharapova s tennis	sports
russian athletes drug said federation	sports
br cricket s cool april	sports
face murray carlo monte raonic th	sports
australia west will side coach	sports
chairs lights stadium cricket organizing iqbal	sports
appoint captain announcement shortly inzamam cricket	sports
board pakistan inzamam s afghanistan cricket	sports
internationals two pakistan team sources whole	sports
inzamam former coach head team pakistan	sports
five madrid game recent barca just	sports
year knee twenty sri malinga world	sports
s four pga tour scotland	sports
world time sport year competitive	sports
atletico head s ball minutes th	sports
matches internationals time s cricket	sports
de ball kock behind runs	sports
australia day players match ball pink	sports
won award s year footballer	sports
rayudu mumbai three balls ball s	sports
hong kong icc corruption	sports
pakistan test v st odi	sports
s kings season knight riders	sports
ancient s first relay sun day	sports
cricket will board committee icc	sports
mumbai challengers took five s	sports
players flower said will lot	sports
sensor ball hawkins cricket t said	sports
world year later malignant team cup	sports
year wimbledon play defending clay murray	sports
matches sources tennis table	sports
year pain sumgong s london	sports
barcelona record nadal ousted benoit	sports
kerber second s siegemund win	sports
umpiring younis said participate pcb pakistan	sports
players sports rugby s bidding starts	sports
umpire bilawal sources incident match pakistan	sports
earn juan footballers strong interview manchester	sports
s title year nishikori	sports
fellow algerian leicester first player year	sports
cricket award development club	sports
s world icc teams afghanistan	sports
day night said unanimous south players	sports
south players said support night day	sports
tournament dispute board west cricket criticised	sports
said finance economic pakistan minister sports	sports
pakistan khan pcb cup	sports
treated tendulkar malinga advice sri kannangara	sports
matches three muhammad players hockey	sports
every two cup islamabad cricketers tests	sports
indian bowling scans pain tri melbourne	sports
coach year australia south cricket	sports
drug results spaniard test	sports
manchester league s real first	sports
cricket s already williamson captain team	sports
report waqar team captain players	sports
twenty west indian team indies	sports
s will mccullum side new	sports
second s tyres supersoft ferrari one	sports
test financial icc captain west indies	sports
players night australian south fixture	sports
will west cricket indian	sports
khan ahmed day punjab butt	sports
round year li th s became	sports
world des hurdles merritt olympic jamaican	sports
voges concussion middlesex bowl head	sports
s t said will pakistan inzamam	sports
messi afghanistan football want ahmedi	sports
englishman strong turned younis pakistan	sports
punjab arm fours balls b c	sports
strong steve wrist australia	sports
s ambassador br goodwill ioa	sports
india lost south africa points icc	sports
june played three host matches will	sports
olympic flame will s opening	sports
academies team proper afridi pakistan	sports
islamabad pakistan media glimpse pleasant s	sports
afridi t cricket said work	sports
chelsea claudio s tottenham leicester title	sports
year won set first match kyrgios	sports
top eight world points will ranked	sports
s league goals time champions	sports
tuesday points champions cantt	sports
hatton alvarez	sports
much still said pakistan comeback	sports
s club much one pounds million	sports
sania mirza collins publishers father book	sports
home fragile feared family number murtaza	sports
said moles coach also position join	sports
dir indies opener s gayle west	sports
s khan loud ahead title	sports
won afghanistan points title pakistan tournament	sports
one south s west africa	sports
south cricket pakistan month s pcb	sports
las strong huge amir title	sports
convinced madrid people accused rafael performance	sports
afridi cricket mistakes national lahore	sports
couple s open besides ivanovic schweinsteiger	sports
binder world fenati navarro s le	sports
defeat s khan power two	sports
team idea said will pcb	sports
club foreign hockey indian pakistan	sports
s ban	sports
djokovic madrid open murray second	sports
bcci s tests year day new	sports
board manohar bcci president cricket indian	sports
singles s players will dilawar abbas	sports
doping information stepanov anti	sports
australia highest hughes helmets wear	sports
world br squash will championship	sports
may column never writing barbados cozier	sports
players tests fitness given official points	sports
women captain world s england year	sports
england one board visa amir s	sports
meet wait passed fifa world tournament	sports
sydney later november cricket struck	sports
ball vince james england	sports
said callers extortion unidentified threat strongin	sports
s cricket independent chairman	sports
cricket test year four lanka	sports
will icc year three appointed jayawardena	sports
s khartoum country crowds spectacle	sports
pakistan will need players said coaching	sports
victory finish stage s finished dutchman	sports
cricket series will time day night	sports
fifa five s night	sports
football government soccer infantino s interference	sports
floodlit oval november attracting form popular	sports
cricket will said grounds	sports
world twenty s possibility icc	sports
chelsea shot goal lindahl london ladies	sports
suarez neymar s messi la barcelona	sports
br saying physical therapy pcb shah	sports
australia month june international zika south	sports
essex tour year last thursday sri	sports
murray s djokovic final day grumpy	sports
england test year player s world	sports
ioc said olympics re international tests	sports
world stokes england sixes s	sports
maxwell cricket australia tuesday	sports
runs test cook england try just	sports
afridi shahid cricket time said	sports
australia new george like bailey	sports
s world year drug hearing test	sports
rashford united s goal	sports
england sri points will test	sports
chief minister cricket said international	sports
test start shanaka s first england	sports
sri lanka first england s lunch	sports
three captains will pakistan said cricket	sports
top king s grand year thai	sports
test new played night day	sports
investment football million deal china far	sports
side completely first three s liverpool	sports
bairstow broad captain wicket	sports
chameera edge s bairstow broad anderson	sports
s bairstow failed catch first second	sports
game series super will	sports
woman said summits	sports
samples athletes examined olympic russian games	sports
chamber s adjudicatory code said report	sports
million second league major	sports
event rio world olympics s hands	sports
two murray number world said	sports
mourad gold brussels suicide s strong	sports
year summit died	sports
quoted meldonium sharapova situation s	sports
will said tests england fitness players	sports
s visa amir bowler said pcb	sports
job three first extra minutes time	sports
s bcci cricket board india	sports
honorary secretary board cricket chairman resigned	sports
will various started career shooting minhal	sports
first second won test england stokes	sports
heavy rain matches weather forecasts showers	sports
test adelaide conditions ball year day	sports
knee match br azarenka called finally	sports
s gaal cup united monday club	sports
england injury s innings	sports
kattner immediate said statement	sports
strong mohammad said inzamam pakistan team	sports
cricket abbas bilateral said ipl pakistan	sports
year world ronaldo portugal s semi	sports
mourinho chelsea s league cup	sports
lanka sri s friday	sports
strong one suspended banned	sports
role believes sri broad runs	sports
previously focused investigations strongfederal probe strong	sports
injuries grappling tour embrace bowlers	sports
couple games day bit november	sports
says barcelona cristiano strong	sports
strong left open french	sports
just boundary runs days england cook	sports
selector appointed november test england will	sports